111111111
100C000P1
101111111
100000001
100111101
11000C1E1
111111111